00000000000000000
00000000000000000
00002111113000000
00001666661000000
00001611161000000
00001661116000000
00001166666000000
00005111114000000
00000000000000000
00000000000000000
00000000000000000
00000000000000000
00000000000000000
00000000000000000
00000000000000000
00000000000000000
00000000000000000